NO ./textures/north.png
SO ./textures/south.png
WE ./textures/east.png
EA ./textures/west.png


F 127,127,127
C 0,127,127


111111111111
100010000001
100010000001
100001000001
10000N000001
100000000001
100100000001
100010000001
100000000001
111111111111