NO ./textures/one.png
SO ./textures/two.png
WE ./textures/three.png
EA ./textures/four.png


F 220,200,0



C 225,30,0

111111111111111   111
100000000000000     001
100000000000000     001
100000000011111     111
10000000001
10000000001
10000000001
100000000011111   111
100000000000000   001
100000000000000   001
100000000000000   001
100000000000000   001
100000000000000   001
111111111111111   111
111111111111111   111