NO ./textures/one.png
SO ./textures/two.png
WE ./textures/three.png
EA ./textures/four.png


F 220,200,0



C 225,30,0

111111111111111111
100000000000000001
100000000000000001
100000000000000001
100000000000000001
100000000000000001
100000000000000001
100000000000000001
100000000000000001
100000000000000001      11111
100000000000000001      10001
100000000000000001111   11111
100000000000000000001
1000000000000000N0111
11111111111111111111111