NO ./textures/one.png
SO ./textures/two.png
WE ./textures/three.png
EA ./textures/four.png


F 220,200,0



C 225,30,0



11111111111
100 0000001
100 0N   01
111111111110