BB reter
SG WSEGWEG
WD WOEGWIOEN
CD SOIEJGIOWEGOIW

F sngsdnjsgsd
C wegwiegnwigjwo

1111111
1000001
1000001
1111111